--------------------------------------------
----################----####################
----#--------------------------------------#
----#--------------------------------------#
----#--------------------------------------#
#####---------------------------------------
--------------------------------------------
--------------------------------------------
---------$#########################$$#######
---------$#$$$$$$$$$$$$$$$$$$$$$$$$$$$$$$$$$
---------$#$$$$$$$$$$$$$$$$$$$$$$$$$$$$$$$$$
---------$#$--------------------------------
---------$#$--------------------------------
---------$#$--------------------------------
###########$--------------------------------
###########$--------------------------------
$$$$$$$$$$$$--------------------------------
--------------------------------------------
--------------------------------------------
--------------------------------------------
--------------------------------------------
--------------------------------------------
--------------------------------------------
--------------------------------------------
--------------------------------------------
--------------------------------------------
--------------------------------------------
--------------------------------------------
--------------------------------------------
--------------------------------------------
--------------------------------------------
--------------------------------------------
--------------------------------------------
--------------------------------------------
--------------------------------------------