----++++++++++++++++----++++++++++++++++++++
----+--------------------------------------+
----+--------------------------------------+
----+--------------------------------------+
+++++---------------------------------------
--------------------------------------------
--------------------------------------------
--------------------------------------------
---------41111111111111111111111111111111111
---------82222222222222222222222222222222222
---------82a33333333333333333333333333333333
---------829--------------------------------
---------829--------------------------------
---------829--------------------------------
111111111d29--------------------------------
222222222229--------------------------------
333333333337--------------------------------
--------------------------------------------
--------------------------------------------
--------------------------------------------
--------------------------------------------
--------------------------------------------
--------------------------------------------
--------------------------------------------
--------------------------------------------
--------------------------------------------
--------------------------------------------
--------------------------------------------
--------------------------------------------
--------------------------------------------
--------------------------------------------
--------------------------------------------
--------------------------------------------
--------------------------------------------
--------------------------------------------
--------------------------------------------
--------------------------------------------
