-------------829---------------------------#
-------------829---------------------------#
---------4111d29---------------------------#
---------82zzzz9---------------------------#
---------8za3337---------------------------#
---------8z9-------------------------------#
---------8z9-------------------------------#
---------829-------------------------------#
111111111d29-------------------------------#
222222222229-------------------------------#
333333333337-------------------------------#
-------------------------------------------#
-------------------------------------------#
-------------------------------------------#
-------------------------------------------#
-------------------------------------------#
-------------------------------------------#
-------------------------------------------#
-------------------------------------------#
-------------------------------------------#
-------------------------------------------#
-------------------------------------------#
-------------------------------------------#
-------------------------------------------#
-------------------------------------------#
-------------------------------------------#
-------------------------------------------#